3 3 3 3 3 2 2 2 2 2 2 2 2 2 2 2 2 2 2 3 3 3 3 3 3 3 3 3 3 3 3 3
3 3 3 3 23 23 2 2 2 2 2 2 2 2 2 2 2 2 2 23 3 3 3 3 3 3 3 3 3 3 3 3
3 3 3 3 3 2 2 2 2 2 2 2 2 2 2 2 2 2 2 23 3 3 3 3 3 3 3 3 3 3 3 3
3 3 3 3 3 2 2 2 2 2 2 2 2 2 2 2 2 2 2 23 3 3 3 3 3 3 3 3 3 3 3 3
3 3 3 3 3 2 2 2 2 2 2 2 2 2 2 2 2 2 2 23 3 3 3 3 3 3 3 3 3 3 3 3
3 3 3 3 3 234 24 24 2 2 2 23 23 23 23 23 2 2 2 234 3 3 3 34 34 34 34 34 34 34 34 4
3 3 4 4 4 4 4 24 2 2 2 23 3 3 3 23 2 2 2 234 4 4 4 4 4 4 4 4 4 4 4 4
3 3 4 4 4 4 4 24 2 2 2 23 3 3 3 23 2 2 2 24 4 4 4 4 4 4 4 4 4 4 4 4
3 3 4 4 4 4 4 24 2 2 2 23 3 3 3 23 2 2 2 24 4 4 4 4 4 4 4 4 4 4 4 4
3 34 34 34 4 4 4 234 2 2 2 23 3 3 3 23 2 2 2 24 24 24 24 24 24 24 24 4 4 4 4 4
3 3 3 3 3 3 3 234 2 2 2 3 3 3 3 23 2 2 2 2 2 2 2 2 2 2 24 4 4 4 4 4
3 3 3 3 3 3 3 23 2 2 2 3 3 3 3 23 2 2 2 2 2 2 2 2 2 2 24 4 4 4 4 4
3 3 3 3 3 3 3 23 2 2 2 3 3 3 3 23 2 2 2 2 2 2 2 2 2 2 24 4 4 4 4 4
3 3 3 3 3 13 13 123 12 124 1234 234 34 34 3 23 2 2 23 23 23 23 23 2 2 2 24 4 4 4 4 4
3 3 3 3 3 1 1 1 1 1 4 4 4 4 3 23 2 23 3 3 3 3 23 2 2 2 24 4 4 4 4 4
3 3 3 3 3 1 1 1 1 1 4 4 4 4 4 2134 1234 3 3 3 3 3 23 2 2 2 234 4 4 4 34 4
3 3 3 3 3 1 1 1 1 1 4 4 4 4 4 2134 1234 3 3 3 3 3 23 2 2 2 234 3 3 3 34 3
3 3 3 3 3 134 14 14 14 14 4 4 4 4 34 3 3 3 3 3 3 3 23 2 2 2 3 3 3 3 3 3
3 3 3 3 3 4 4 4 4 34 4 4 4 34 3 3 3 3 3 3 3 3 23 2 2 2 3 3 3 3 3 3
3 3 3 3 3 4 4 4 4 34 3 3 3 3 3 3 3 3 3 3 3 3 23 2 2 2 3 3 3 3 3 3
3 3 3 3 3 4 4 4 4 34 3 3 3 3 3 3 3 3 3 3 3 3 123 12 12 123 1234 134 34 34 34 3
3 34 34 34 34 34 4 4 4 34 3 3 3 3 3 3 3 3 3 3 3 3 13 1 1 1 1 4 4 4 4 4
4 4 4 4 4 4 4 4 4 34 4 4 4 134 13 13 13 13 13 13 13 13 13 1 1 1 1 4 4 4 4 4
4 4 4 4 4 4 4 4 4 4 4 4 4 14 1 1 1 1 1 1 1 1 1 1 1 1 1 4 4 4 4 4
4 4 4 4 4 4 4 4 4 4 4 4 4 14 1 1 1 1 1 1 1 1 1 1 1 1 14 4 4 4 4 4
4 14 4 4 4 4 4 4 4 4 4 4 4 14 1 1 1 1 1 1 1 1 1 1 1 1 14 4 4 4 4 4
1 14 1 1 1 1 4 4 4 4 4 4 4 14 14 14 14 14 14 14 14 1 1 1 13 13 134 4 4 4 34 4
1 1 1 1 1 14 4 4 4 4 4 4 4 4 4 4 4 4 4 4 4 1 1 1 13 3 3 3 3 3 34 3
1 1 1 1 1 14 4 4 4 4 4 4 4 4 4 4 4 4 4 4 4 1 1 1 13 3 3 3 3 3 3 3
1 1 1 1 1 14 4 4 4 4 4 4 4 4 4 4 4 4 4 4 4 1 1 1 13 3 3 3 3 3 3 3
1 1 1 1 1 14 4 4 4 4 4 4 4 4 4 4 4 4 4 4 14 14 1 1 13 3 3 3 3 3 3 3
1 1 1 1 1 1 4 4 4 4 4 4 4 4 4 4 4 4 4 4 4 4 1 1 1 3 3 3 3 3 3 3
